width = 5632
height = 2048

max_provinces = 6000
sea_starts = { 
	1 5 6 9 10 12 25 26 27 62 90 105 118 120 143 159 164 171 220 335 356 409 445 483 491 563 587 611 627 671 686 702 718 732 770 771 778 815 839 859 869 909 950 974 978 987 1008 1016 1051 1067 1071 1072 1074 1101 1107 1112
	1115 1162 1177 1182 1193 1203 1221 1233 1251 1253 1256 1257 1265 1280 1284 1285 1286 1288 1291 1294 1297 1303 1305 1307 1308 1309 1310 1311 1312 1315 1318 1321 1327 1328 1336 1339 1343 1348 1389 1538 1555 1576 1589
	1645 1671 1691 1759 1813 1828 1831 1872 1898 1899 1941 1947 1957 2017 2060 2116 2171 2175 2218 2223 2261 2293 2294 2335 2372 2382 2408 2417 2430 2443 2449 2450 2455 2459 2462 2496 2509 2567 2587 2608 2618 2654 2689
	2690 2708 2721 2722 2727 2759 2760 2782 2783 2784 2793 2802 2803 2804 2842 2843 2908 2927 2935 2943 2946 2970 2980 2984 2989 2990 2998 3001 3005 3019 3025 3029 3039 3057 3074 3083 3103 3118 3121 3126 3127 3129 3135 3140
	3149 3157 3167 3170 3191 3192 3201 3212 3215 3227 3234 3245 3249 3265 3271 3281 3283 3285 3286 3296 3298 3300 3302 3303 3308 3318 3327 3328 3342 3360 3361 3395 3398 3399 3415 3422 3428 3433 3434 3439 3443 3449 3450 3451
	3474 3518 3526 3540 3542 3546 3576 3581 3595 3599 3603 3613 3638 3646 3649 3650 3676 3680 3684 3696 3708 3743 3747 3759 3760 3761 3762 3778 3798 3809 3815 3835 3843 3846 3891 3964 3969 4001 4048 4072 4082 4109 4152 4160
	4161 4172 4185 4223 4235 4236 4240 4256 4258 4277 4287 4290 4292 4293 4305 4313 4323 4326 4365
}

only_used_for_random = {
}

lakes = {
	422 1496 1617
}

force_coastal = {
}

definitions = "definition.csv"
provinces = "provinces.bmp"
positions = "positions.txt"
terrain = "terrain.bmp"
rivers = "rivers.bmp"
terrain_definition = "terrain.txt"
heightmap = "heightmap.bmp"
tree_definition = "trees.bmp"
continent = "continent.txt"
adjacencies = "adjacencies.csv"
climate = "climate.txt"
region = "region.txt"
superregion = "superregion.txt"
area = "area.txt"
provincegroup = "provincegroup.txt"
ambient_object = "ambient_object.txt"
seasons = "seasons.txt"
trade_winds = "trade_winds.txt"
canal_definition = { #this sets the coordinates for where the panama_canal_river map file is inserted (starting from its bottom left corner)
	name = "panama_canal"
	x = 1490
	y = 948
}
canal_definition = {
	name = "suez_canal"
	x = 3275
	y = 1118
}
canal_definition = {
	name = "kiel_canal"
	x = 2937
	y = 1597
}

# Define which indices in trees.bmp palette which should count as trees for automatic terrain assignment
tree = { 3 4 7 10 }
